shutterstock5.png
255, 0, 255, 255
0, 0, 0, 255
163, 255, 198, 255
0, 255, 182, 255
Colormap
000022220000
000222222000
000022220000
111000000111
111100001111
111110011111
111111111111
111111111111
111111111111
111111111111
000000000000
000000000000
000000000000
Brickmap
000033330000
000311113000
000033330000
111000000111
111100001111
111110011111
111111111111
111111111111
111111111111
222222222222
000000000000
000000000000
000000000000
