022259762-alien-world.jpg
0, 255, 255, 255
0, 0, 0, 255
255, 0, 0, 255
255, 40, 40, 255
255, 128, 128, 255
Colormap
111111111111
111111111111
111111111111
222222222222
222222222222
222222222222
222222222222
333333333333
333333333333
333333333333
000000000000
000000000000
000000000000
Brickmap
000000000000
000000000000
000000000000
000000000000
000000000000
000000000000
000000000000
000000000000
111111111111
000000000000
000000000000
000000000000
000000000000