shutterstock4.png
255, 0, 0, 255
0, 0, 0, 255
101, 97, 255, 255
5, 186, 255, 255
105, 201, 255, 255
Colormap
000000333333
000003333333
000033311111
333333133333
333331333333
333313333333
111133311111
333333100000
333331000000
333310000000
111100000000
000000000000
000000000000
Brickmap
000000111111
000001111111
000011133333
111111311111
111113111111
111131111111
333311133333
111111300000
111113000000
111130000000
333300000000
000000000000
000000000000
