shutterstock3.png
0, 255, 255, 255
0, 0, 0, 255
0, 151, 113, 255
7, 255, 189, 255
128, 143, 128, 255
Colormap
000000000000
033333333330
031111111130
031111111130
033333333330
000000000000
033330033330
032230032230
032230032230
033330033330
000000000000
000000000000
000000000000
Brickmap
000000000000
022222222220
021111111120
021111111120
022222222220
000000000000
022220022220
021120021120
021120021120
022220022220
000000000000
000000000000
000000000000
