065743048-exoplanet-exploration-3d-rende.jpg
0, 255, 0, 255
128, 0, 128, 255
0, 0, 255, 255
230, 0, 115, 255
0, 128, 192, 255
Colormap
222222222222
222222222222
222222222222
222222222222
222222222222
222222222222
222222222222
222222222222
222222222222
222222222222
000000000000
000000000000
000000000000
Brickmap
222000000222
202000000202
222000000222
000333333000
000111111000
000333333000
220000000022
002200002200
000022220000
000011110000
000011110000
000000000000
000000000000