065743048-exoplanet-exploration-3d-rende.jpg
0, 255, 0, 255
128, 0, 128, 255
0, 0, 255, 255
230, 0, 115, 255
0, 128, 192, 255
Colormap
333333333333
222222222222
333332233333
222222222222
222222222222
222222222222
333333333333
333333333333
333333333333
333333333333
000000000000
000000000000
000000000000
Brickmap
111100001111
022222222220
111103301111
000022220000
000003300000
000111111000
000111111000
222000000222
222000000222
000000000000
000000000000
000000000000
000000000000