065743048-exoplanet-exploration-3d-rende.jpg
0, 255, 0, 255
128, 0, 128, 255
0, 0, 255, 255
230, 0, 115, 255
0, 128, 192, 255
Colormap
001100001100
330033330033
330033330033
001100001100
000000000000
222222222222
000000000000
001100001100
330033330033
330033330033
001100001100
000000000000
000000000000
Brickmap
001100001100
330033330033
330033330033
001100001100
000000000000
222222222222
000000000000
001100001100
330033330033
330033330033
001100001100
000000000000
000000000000