065743048-exoplanet-exploration-3d-rende.jpg
0, 255, 0, 255
128, 0, 128, 255
0, 0, 255, 255
230, 0, 115, 255
0, 128, 192, 255
Colormap
333333333333
222222222222
111111111111
333333333333
111222222222
111111111111
333333333333
222222222222
111111111111
333333333333
000000000000
000000000000
000000000000
Brickmap
222000003333
002220000333
000022200033
000000222003
333000002223
333000002223
000000222003
000022200033
002220000333
222000003333
000000000000
000000000000
000000000000