065743048-exoplanet-exploration-3d-rende.jpg
0, 255, 0, 255
128, 0, 128, 255
0, 0, 255, 255
230, 0, 115, 255
0, 128, 192, 255
Colormap
333333333333
333333333333
111111111111
111111111111
222222222222
222222222222
222222222222
111111111111
111111111111
333333333333
333333333333
000000000000
000000000000
Brickmap
000011110000
000333333000
003333333300
011111111110
222222222222
222000000222
222000000222
222222222222
033333333330
001111111100
000311113000
000000000000
000000000000