065743048-exoplanet-exploration-3d-rende.jpg
0, 255, 0, 255
128, 0, 128, 255
0, 0, 255, 255
230, 0, 115, 255
0, 128, 192, 255
Colormap
333333333333
111111111111
111111111111
222222222222
222222222222
222222222222
222222222222
111111111111
111111111111
333333333333
000000000000
000000000000
000000000000
Brickmap
000001100000
000022220000
000333333000
001111111100
333333333333
110000000011
333333333333
001111111100
000333333000
000022220000
000000000000
000000000000
000000000000