065743048-exoplanet-exploration-3d-rende.jpg
0, 255, 0, 255
128, 0, 128, 255
0, 0, 255, 255
230, 0, 115, 255
0, 128, 192, 255
Colormap
333333333333
222222222222
222222222222
222222222222
222222222222
222222222222
222222222222
222222222222
333333333333
111111111111
111111111111
000000000000
000000000000
Brickmap
222222222222
002220000222
000022200022
000000222002
000000002220
000000222002
000022200022
002220000222
222222222222
000000003330
000000003330
000000000000
000000000000