065743048-exoplanet-exploration-3d-rende.jpg
0, 255, 0, 255
128, 0, 128, 255
0, 0, 255, 255
128, 128, 255, 255
0, 128, 192, 255
Colormap
111111111111
111111111111
111111111111
222222222222
222222222222
222222222222
222222222222
111111111111
111111111111
333333333333
000000000000
000000000000
000000000000
Brickmap
000000000000
000000000000
000000000000
000000000000
000000000000
000000000000
000000000000
101010101010
010101010101
000000000000
000000000000
000000000000
000000000000