065743048-exoplanet-exploration-3d-rende.jpg
0, 255, 0, 255
128, 0, 128, 255
0, 0, 255, 255
230, 0, 115, 255
0, 128, 192, 255
Colormap
111111111111
111111111111
333333333333
111111111111
333333333333
333333333333
111111111111
333333333333
222222222222
222222222222
222222222222
000000000000
000000000000
Brickmap
000000000000
111100001111
222200002222
212121212121
000003300000
000003300000
002220022200
002220022200
110000000011
110000000011
333000000333
000000000000
000000000000