065743048-exoplanet-exploration-3d-rende.jpg
0, 255, 0, 255
128, 0, 128, 255
0, 0, 255, 255
230, 0, 115, 255
0, 128, 192, 255
Colormap
333333333333
111111111111
333333333333
111111111111
333333333333
111111111111
333333333333
111111111111
333333333333
111111111111
333333333333
000000000000
000000000000
Brickmap
222000000222
000222222000
000222222000
002000000200
010000000010
100000000001
010000000010
003300003300
003300003300
003300003300
003300003300
000000000000
000000000000