065743048-exoplanet-exploration-3d-rende.jpg
0, 255, 0, 255
128, 0, 128, 255
0, 0, 255, 255
230, 0, 115, 255
0, 128, 192, 255
Colormap
333333333333
333333333333
333333333333
222222222222
222222222222
222222222222
222222222222
111111111111
111111111111
111111111111
111111111111
000000000000
000000000000
Brickmap
111100001111
330000000033
333000000333
000333333000
000333333000
000111111000
000111111000
222220022222
033300003330
022200002220
222220022222
000000000000
000000000000