065743048-exoplanet-exploration-3d-rende.jpg
0, 255, 0, 255
128, 0, 128, 255
0, 0, 255, 255
230, 0, 115, 255
0, 128, 192, 255
Colormap
111111111111
111111111111
111111111111
222222222222
222222222222
222222222222
222222222222
211111111112
222222222222
333333333333
000000000000
000000000000
000000000000
Brickmap
000000000000
000000000000
000000000000
000000000000
000000000000
000000000000
222011110222
100110011001
121012210121
000000000000
000000000000
000000000000
000000000000