037162994-sunset-illeo.jpg
64, 128, 128, 255
0, 0, 255, 255
0, 255, 255, 255
192, 192, 192, 255
255, 255, 0, 255
Colormap
222220022222
033300003330
022200002220
033300003330
022200002220
222220022222
111100001111
330000000033
000333001111
333001111111
000333001111
000000000000
000000000000
Brickmap
222220022222
033300003330
022200002220
033300003330
022200002220
222220022222
111100001111
330000000033
000333001111
333001111111
000333001111
000000000000
000000000000