037162994-sunset-illeo.jpg
64, 128, 128, 255
0, 0, 255, 255
0, 255, 255, 255
192, 192, 192, 255
255, 255, 0, 255
Colormap
111002200111
222200000022
000333333000
000111111000
000321123000
000322223000
002222222200
033300003330
000033330000
222002200222
000220022000
000000000000
000000000000
Brickmap
111002200111
222200000022
000333333000
000111111000
000321123000
000322223000
002222222200
033300003330
000033330000
222002200222
000220022000
000000000000
000000000000