037162994-sunset-illeo.jpg
64, 128, 128, 255
0, 0, 255, 255
0, 255, 255, 255
192, 192, 192, 255
255, 255, 0, 255
Colormap
330033330033
001100001100
000003111111
000031111111
000000000000
001110011100
000111111000
000311113000
000000222003
000022200033
000000000000
000000000000
000000000000
Brickmap
330033330033
001100001100
000003111111
000031111111
000000000000
001110011100
000111111000
000311113000
000000222003
000022200033
000000000000
000000000000
000000000000