037162994-sunset-illeo.jpg
64, 128, 128, 255
0, 0, 255, 255
0, 255, 255, 255
192, 192, 192, 255
255, 255, 0, 255
Colormap
002200002200
000022220000
000022200033
000000222003
333000002223
333000002223
002200002200
000022220000
000022220000
002200002200
002220000333
000000000000
000000000000
Brickmap
002200002200
000022220000
000022200033
000000222003
333000002223
333000002223
002200002200
000022220000
000022220000
002200002200
002220000333
000000000000
000000000000