037162994-sunset-illeo.jpg
64, 128, 128, 255
0, 0, 255, 255
0, 255, 255, 255
192, 192, 192, 255
255, 255, 0, 255
Colormap
111002200111
221100001122
222221122222
333321123333
000321123000
000322223000
000333333000
010010010010
010010010010
333000002223
000000222003
000000000000
000000000000
Brickmap
111002200111
221100001122
222221122222
333321123333
000321123000
000322223000
000333333000
010010010010
010010010010
333000002223
000000222003
000000000000
000000000000