037162994-sunset-illeo.jpg
64, 128, 128, 255
0, 0, 255, 255
0, 255, 255, 255
192, 192, 192, 255
255, 255, 0, 255
Colormap
222220022222
000000000000
111110011111
222220022222
000000000000
111110011111
222220022222
000000000000
111110011111
222222222222
011111111110
000000000000
000000000000
Brickmap
222220022222
000000000000
111110011111
222220022222
000000000000
111110011111
222220022222
000000000000
111110011111
222222222222
011111111110
000000000000
000000000000