037162994-sunset-illeo.jpg
64, 128, 128, 255
0, 0, 255, 255
0, 255, 255, 255
192, 192, 192, 255
255, 255, 0, 255
Colormap
212121212121
000003300000
111100001111
330000000033
002200002200
000022220000
000111111000
222220022222
003300003300
003300003300
003300003300
000000000000
000000000000
Brickmap
212121212121
000003300000
111100001111
330000000033
002200002200
000022220000
000111111000
222220022222
003300003300
003300003300
003300003300
000000000000
000000000000