037162994-sunset-illeo.jpg
64, 128, 128, 255
0, 0, 255, 255
0, 255, 255, 255
192, 192, 192, 255
255, 255, 0, 255
Colormap
222000000222
222000000222
222222222222
001100001100
330033330033
330033330033
033330000000
000000000000
000011110000
330033330033
330033330033
000000000000
000000000000
Brickmap
222000000222
222000000222
222222222222
001100001100
330033330033
330033330033
033330000000
000000000000
000011110000
330033330033
330033330033
000000000000
000000000000