037162994-sunset-illeo.jpg
64, 128, 128, 255
0, 0, 255, 255
0, 255, 255, 255
192, 192, 192, 255
255, 255, 0, 255
Colormap
222222222222
110010010011
111111300000
000111111000
222220022222
033300003330
022200002220
222000000222
222222222222
033333333330
001111111100
000000000000
000000000000
Brickmap
222222222222
110010010011
111111300000
000111111000
222220022222
033300003330
022200002220
222000000222
222222222222
033333333330
001111111100
000000000000
000000000000