037162994-sunset-illeo.jpg
64, 128, 128, 255
0, 0, 255, 255
0, 255, 255, 255
192, 192, 192, 255
255, 255, 0, 255
Colormap
000222000222
222000222000
212000212000
222000222000
222222222222
011111111110
001111111100
000111111000
000011110000
000333333000
000333333000
000000000000
000000000000
Brickmap
000222000222
222000222000
212000212000
222000222000
222222222222
011111111110
001111111100
000111111000
000011110000
000333333000
000333333000
000000000000
000000000000