037162994-sunset-illeo.jpg
64, 128, 128, 255
0, 0, 255, 255
0, 255, 255, 255
192, 192, 192, 255
255, 255, 0, 255
Colormap
000333333000
220000000022
002200002200
000022220000
111001100111
222002200222
003300003300
000333333000
010010010010
333000002223
000212000212
000000000000
000000000000
Brickmap
000333333000
220000000022
002200002200
000022220000
111001100111
222002200222
003300003300
000333333000
010010010010
333000002223
000212000212
000000000000
000000000000