039839543-fantastic-landscape.jpg
128, 0, 0, 255
128, 0, 128, 255
171, 88, 88, 255
0, 170, 170, 255
89, 89, 255, 255
Colormap
222000000222
222222222222
033333333330
001111111100
000321123000
222000000222
010010010010
020020020020
021112211120
000022220000
000111111000
000000000000
000000000000
Brickmap
222000000222
222222222222
033333333330
001111111100
000321123000
222000000222
010010010010
020020020020
021112211120
000022220000
000111111000
000000000000
000000000000