039839543-fantastic-landscape.jpg
128, 0, 0, 255
128, 0, 128, 255
171, 88, 88, 255
0, 170, 170, 255
89, 89, 255, 255
Colormap
000000000000
333333333333
000111111000
222220022222
030202020033
303020202003
033333333330
000022220000
000022220000
002200002200
000033330000
000000000000
000000000000
Brickmap
000000000000
333333333333
000111111000
222220022222
030202020033
303020202003
033333333330
000022220000
000022220000
002200002200
000033330000
000000000000
000000000000