039839543-fantastic-landscape.jpg
128, 0, 0, 255
128, 0, 128, 255
171, 88, 88, 255
0, 170, 170, 255
89, 89, 255, 255
Colormap
222220022222
022222222220
021112211120
022222222220
222000000222
000333333000
000321123000
000321123000
122100000001
110000000011
100000001221
000000000000
000000000000
Brickmap
222220022222
022222222220
021112211120
022222222220
222000000222
000333333000
000321123000
000321123000
122100000001
110000000011
100000001221
000000000000
000000000000