039839543-fantastic-landscape.jpg
128, 0, 0, 255
128, 0, 128, 255
171, 88, 88, 255
0, 170, 170, 255
89, 89, 255, 255
Colormap
222222222222
110010010011
111111300000
300300300300
222220022222
001100001100
330033330033
330033330033
222200002222
002222222200
000033330000
000000000000
000000000000
Brickmap
222222222222
110010010011
111111300000
300300300300
222220022222
001100001100
330033330033
330033330033
222200002222
002222222200
000033330000
000000000000
000000000000