039839543-fantastic-landscape.jpg
128, 0, 0, 255
128, 0, 128, 255
171, 88, 88, 255
0, 170, 170, 255
89, 89, 255, 255
Colormap
000000000000
000222222000
111111111111
000022220000
111110011111
111000000111
100000000001
333333333333
011100001110
333333333333
222000000222
222220022222
000000000000
Brickmap
000000000000
000222222000
111111111111
000022220000
111110011111
111000000111
100000000001
002220022200
011100001110
200220022002
222000000222
222220022222
000000000000