039839543-fantastic-landscape.jpg
128, 0, 0, 255
128, 0, 128, 255
171, 88, 88, 255
0, 170, 170, 255
89, 89, 255, 255
Colormap
011002200110
022001100220
022001100220
011002200110
000110011000
000220022000
000220022000
111110011111
000222222000
000022220000
000000000000
000000000000
000000000000
Brickmap
011002200110
022001100220
022001100220
011002200110
000110011000
000220022000
000220022000
111110011111
000222222000
000022220000
000000000000
000000000000
000000000000