039839543-fantastic-landscape.jpg
128, 0, 0, 255
128, 0, 128, 255
171, 88, 88, 255
0, 170, 170, 255
89, 89, 255, 255
Colormap
222002200222
333311111333
111111113333
221112222000
221111112222
222222222222
021111111120
021111111120
033333333330
000022220000
333333333333
000000000000
000000000000
Brickmap
222002200222
333311111333
111111113333
221112222000
221111112222
222222222222
021111111120
021111111120
033333333330
000022220000
333333333333
000000000000
000000000000