039839543-fantastic-landscape.jpg
128, 0, 0, 255
128, 0, 128, 255
171, 88, 88, 255
0, 170, 170, 255
89, 89, 255, 255
Colormap
000031111111
333311111333
000111111000
222220022222
033300003330
022200002220
000000002222
000000000022
333333333300
333333330000
000000333333
000000000000
000000000000
Brickmap
000031111111
333311111333
000111111000
222220022222
033300003330
022200002220
000000002222
000000000022
333333333300
333333330000
000000333333
000000000000
000000000000