039839543-fantastic-landscape.jpg
128, 0, 0, 255
128, 0, 128, 255
171, 88, 88, 255
0, 170, 170, 255
89, 89, 255, 255
Colormap
221112222000
221111112222
000333311133
333311111133
333333333333
330033330033
330033330033
001100001100
002120002120
021112021112
000333333000
000000000000
000000000000
Brickmap
221112222000
221111112222
000333311133
333311111133
333333333333
330033330033
330033330033
001100001100
002120002120
021112021112
000333333000
000000000000
000000000000