039839543-fantastic-landscape.jpg
128, 0, 0, 255
128, 0, 128, 255
171, 88, 88, 255
0, 170, 170, 255
89, 89, 255, 255
Colormap
000000000000
000000000000
000000000000
000000000000
111111111111
222222222222
000222222000
000111111000
222222222222
111111111111
000000000000
000000000000
000000000000
Brickmap
000000000000
000000000000
000000000000
000000000000
111111111111
222222222222
000222222000
000111111000
222222222222
111111111111
000000000000
000000000000
000000000000