039839543-fantastic-landscape.jpg
128, 0, 0, 255
128, 0, 128, 255
171, 88, 88, 255
0, 170, 170, 255
89, 89, 255, 255
Colormap
000231232210
000001110000
022233111112
323223232323
002310000000
000000001111
111111111111
023120000000
000000000012
022222222220
001111110001
000000000000
000000000000
Brickmap
000231232210
000001110000
022233111112
323223232323
002310000000
000000001111
010101010101
023120000000
000000000012
022222222220
001111110001
000000000000
000000000000