039839543-fantastic-landscape.jpg
128, 0, 0, 255
128, 0, 128, 255
171, 88, 88, 255
0, 170, 170, 255
89, 89, 255, 255
Colormap
222000033333
003003300300
333003300333
000000000000
030202020033
333333333333
010101010101
222220022222
221111130000
010010010010
333000002223
000000000000
000000000000
Brickmap
222000033333
003003300300
333003300333
000000000000
030202020033
333333333333
010101010101
222220022222
221111130000
010010010010
333000002223
000000000000
000000000000