065090581-exoplanet-exploration.jpg
255, 255, 0, 255
53, 53, 255, 255
255, 174, 255, 255
187, 0, 92, 255
255, 255, 0, 255
Colormap
000000000000
110010010011
111111300000
033300003330
022200002220
222000000222
222202000033
222022000003
220222000000
000000111100
000011110000
000000000000
000000000000
Brickmap
000000000000
110010010011
111111300000
033300003330
022200002220
222000000222
222202000033
222022000003
220222000000
000000111100
000011110000
000000000000
000000000000