065090581-exoplanet-exploration.jpg
255, 255, 0, 255
53, 53, 255, 255
255, 174, 255, 255
187, 0, 92, 255
255, 255, 0, 255
Colormap
001100001100
003211112300
000321123000
000321123000
222000000222
033333333330
000022220000
220000000022
111111111111
003300003300
003300003300
000000000000
000000000000
Brickmap
001100001100
003211112300
000321123000
000321123000
222000000222
033333333330
000022220000
220000000022
111111111111
003300003300
003300003300
000000000000
000000000000