065090581-exoplanet-exploration.jpg
255, 255, 0, 255
53, 53, 255, 255
255, 174, 255, 255
187, 0, 92, 255
255, 255, 0, 255
Colormap
021111111120
021111111120
000011110000
022222222220
000022220000
003303303300
000330033000
000033330000
000001100000
012100001210
000000000000
000000000000
000000000000
Brickmap
021111111120
021111111120
000011110000
022222222220
000022220000
003303303300
000330033000
000033330000
000001100000
012100001210
000000000000
000000000000
000000000000