065090581-exoplanet-exploration.jpg
255, 255, 0, 255
53, 53, 255, 255
255, 174, 255, 255
187, 0, 92, 255
255, 255, 0, 255
Colormap
000000000000
000000010011
111111300000
000111000000
111110011111
111111111111
222220022222
003330033300
110100000000
000021111111
000000000000
000000000000
000000000000
Brickmap
000000000000
000000010011
111111300000
000111000000
111110011111
111111111111
222220022222
003330033300
110100000000
000021111111
000000000000
000000000000
000000000000