065090581-exoplanet-exploration.jpg
255, 255, 0, 255
53, 53, 255, 255
255, 174, 255, 255
187, 0, 92, 255
255, 255, 0, 255
Colormap
000222222000
001011110100
010000000010
100000000001
022211112220
200000000002
020000000020
002011110200
000200002000
000011110000
000000000000
000000000000
000000000000
Brickmap
000222222000
001011110100
010000000010
100000000001
022211112220
200000000002
020000000020
002011110200
000200002000
000011110000
000000000000
000000000000
000000000000