065090581-exoplanet-exploration.jpg
255, 255, 0, 255
53, 53, 255, 255
255, 174, 255, 255
187, 0, 92, 255
255, 255, 0, 255
Colormap
000021112000
000002220000
000200200200
002120002120
021112021112
333333333333
000022220000
333333333333
000333001111
000000333001
000000000333
000000000000
000000000000
Brickmap
000021112000
000002220000
000200200200
002120002120
021112021112
333333333333
000022220000
333333333333
000333001111
000000333001
000000000333
000000000000
000000000000