065090581-exoplanet-exploration.jpg
255, 255, 0, 255
53, 53, 255, 255
255, 174, 255, 255
187, 0, 92, 255
255, 255, 0, 255
Colormap
111000000000
111100000000
111110000000
111111000000
111110000333
111100333001
111033001111
110301111111
100033001111
000000333001
000000000333
000000000000
000000000000
Brickmap
111000000000
111100000000
111110000000
111111000000
111110000333
111100333001
111033001111
110301111111
100033001111
000000333001
000000000333
000000000000
000000000000