065090581-exoplanet-exploration.jpg
255, 255, 0, 255
53, 53, 255, 255
255, 174, 255, 255
187, 0, 92, 255
255, 255, 0, 255
Colormap
000000000000
000000011220
011220000000
000002331200
000011212121
011000000000
000011100330
001212120033
330000012121
001212120000
000000000000
000000000000
000000000000
Brickmap
000000000000
000000011220
011220000000
000002331200
000011212121
011000000000
000011100330
001212120033
330000012121
001212120000
000000000000
000000000000
000000000000