065090581-exoplanet-exploration.jpg
255, 255, 0, 255
53, 53, 255, 255
255, 174, 255, 255
187, 0, 92, 255
255, 255, 0, 255
Colormap
110000000011
001100001100
222222222222
222000000222
222000000222
222222222222
001100001100
110003300011
003330033300
000033330000
000000000000
000000000000
000000000000
Brickmap
110000000011
001100001100
222222222222
222000000222
222000000222
222222222222
001100001100
110003300011
003330033300
000033330000
000000000000
000000000000
000000000000