065090581-exoplanet-exploration.jpg
255, 255, 0, 255
53, 53, 255, 255
255, 174, 255, 255
187, 0, 92, 255
255, 255, 0, 255
Colormap
221100001122
222221122222
021112211120
022222222220
000011110000
010010010010
010010010010
333000002223
000000222003
021120021120
021120021120
000000000000
000000000000
Brickmap
221100001122
222221122222
021112211120
022222222220
000011110000
010010010010
010010010010
333000002223
000000222003
021120021120
021120021120
000000000000
000000000000