065090581-exoplanet-exploration.jpg
255, 255, 0, 255
53, 53, 255, 255
255, 174, 255, 255
187, 0, 92, 255
255, 255, 0, 255
Colormap
022000000000
000000003330
022200000000
000000000330
000000000000
000111111000
000011110000
000001100000
000011110000
000111111000
000000000000
000000000000
000000000000
Brickmap
011000000000
000000001110
011100000000
000000000110
000000000000
000111111000
000011110000
000001100000
000011110000
000111111000
000000000000
000000000000
000000000000