065090581-exoplanet-exploration.jpg
255, 255, 0, 255
53, 53, 255, 255
255, 174, 255, 255
187, 0, 92, 255
255, 255, 0, 255
Colormap
111111111000
000000000000
333000033333
000000000000
111111111000
000000000000
333000033333
000000000000
111111111000
000000000000
333000033333
000000000000
000000000000
Brickmap
111111111000
000000000000
333000033333
000000000000
111111111000
000000000000
333000033333
000000000000
111111111000
000000000000
333000033333
000000000000
000000000000