022259762-alien-world.jpg
255, 255, 0, 255
128, 0, 128, 255
255, 64, 159, 255
255, 102, 102, 255
236, 0, 236, 255
Colormap
333333333333
030030030030
030030030030
030030030030
222222222222
020020020020
020020020020
010010010010
010010010010
020020020020
000000000000
000000000000
000000000000
Brickmap
111111111111
010010010010
010010010010
010010010010
222222222222
010010010010
010010010010
010010010010
010010010010
020020020020
000000000000
000000000000
000000000000
