022259762-alien-world.jpg
255, 255, 0, 255
128, 0, 128, 255
255, 64, 159, 255
255, 102, 102, 255
236, 0, 236, 255
Colormap
111111111111
111111111111
111111111111
222222222222
222222222222
222222222222
222222222222
333333333333
111111111111
333333333333
000000000000
000000000000
000000000000
Brickmap
000000000000
000000000000
000000000000
000000000000
000000000000
000000000000
000000000000
000000000000
111111111111
000000000000
000000000000
000000000000
000000000000