022259762-alien-world.jpg
255, 255, 0, 255
128, 0, 128, 255
255, 64, 159, 255
255, 102, 102, 255
236, 0, 236, 255
Colormap
000000000000
000333000333
000333000333
000333000333
222000222000
222000222000
222000222000
000111000111
000111000111
000111000111
000000000000
000000000000
000000000000
Brickmap
000000000000
000222000222
000212000212
000222000222
222000222000
212000212000
222000222000
000222000222
000212000212
000222000222
000000000000
000000000000
000000000000
