022259762-alien-world.jpg
255, 255, 0, 255
128, 0, 128, 255
255, 64, 159, 255
255, 102, 102, 255
236, 0, 236, 255
Colormap
002222222200
002222222200
000222222000
000022220000
111002200111
111100001111
011110011110
001111111100
000111111000
000011110000
000001100000
000000000000
000000000000
Brickmap
002111111200
002211112200
000221122000
000022220000
111002200111
221100001122
022110011220
002211112200
000221122000
000022220000
000002200000
000000000000
000000000000
