029655296-mountains-landscape.jpg
255, 0, 255, 255
53, 53, 255, 255
0, 255, 255, 255
128, 255, 0, 255
255, 128, 64, 255
Colormap
001100001100
002120002120
021112021112
000333333000
221112222000
221111112222
000333311133
333311111133
333333333333
000333333000
010010010010
000000000000
000000000000
Brickmap
001100001100
002120002120
021112021112
000333333000
221112222000
221111112222
000333311133
333311111133
333333333333
000333333000
010010010010
000000000000
000000000000