029655296-mountains-landscape.jpg
255, 0, 255, 255
53, 53, 255, 255
0, 255, 255, 255
128, 255, 0, 255
255, 128, 64, 255
Colormap
222210000000
122222210000
222222222222
011111111110
333000002223
333000002223
001100001100
330033330033
330033330033
010101010101
222220022222
000000000000
000000000000
Brickmap
222210000000
122222210000
222222222222
011111111110
333000002223
333000002223
001100001100
330033330033
330033330033
010101010101
222220022222
000000000000
000000000000