029655296-mountains-landscape.jpg
255, 0, 255, 255
53, 53, 255, 255
0, 255, 255, 255
128, 255, 0, 255
255, 128, 64, 255
Colormap
111110011111
222220022222
000000000000
111110011111
222222222222
011111111110
111111111111
111111111111
333003300333
333003300333
020020020020
000000000000
000000000000
Brickmap
111110011111
222220022222
000000000000
111110011111
222222222222
011111111110
111111111111
111111111111
333003300333
333003300333
020020020020
000000000000
000000000000