029655296-mountains-landscape.jpg
255, 0, 255, 255
53, 53, 255, 255
0, 255, 255, 255
128, 255, 0, 255
255, 128, 64, 255
Colormap
000022220000
000022220000
002200002200
222222222222
222000000222
333333333333
113313313311
111111330000
111113300000
111133000000
000000000000
000000000000
000000000000
Brickmap
000022220000
000022220000
002200002200
222222222222
222000000222
333333333333
113313313311
111111330000
111113300000
111133000000
000000000000
000000000000
000000000000