029655296-mountains-landscape.jpg
255, 0, 255, 255
53, 53, 255, 255
0, 255, 255, 255
128, 255, 0, 255
255, 128, 64, 255
Colormap
000000000000
110010010011
110010010011
222222222222
110010010011
110010010011
333003300333
111111111111
111111111111
333003300333
000000000000
000000000000
000000000000
Brickmap
000000000000
110010010011
110010010011
222222222222
110010010011
110010010011
333003300333
111111111111
111111111111
333003300333
000000000000
000000000000
000000000000