029655296-mountains-landscape.jpg
255, 0, 255, 255
53, 53, 255, 255
0, 255, 255, 255
128, 255, 0, 255
255, 128, 64, 255
Colormap
222211112222
000211112000
000211112000
022211112220
021111111120
021111111120
021111111120
002222222200
000222222000
000022220000
000000000000
000000000000
000000000000
Brickmap
222211112222
000211112000
000211112000
022211112220
021111111120
021111111120
021111111120
002222222200
000222222000
000022220000
000000000000
000000000000
000000000000