029655296-mountains-landscape.jpg
255, 0, 255, 255
53, 53, 255, 255
0, 255, 255, 255
128, 255, 0, 255
255, 128, 64, 255
Colormap
000111111000
222220022222
033300003330
222222222222
001100001100
110003300011
333311113333
111111111111
111111111111
222221122222
000000000000
000000000000
000000000000
Brickmap
000111111000
222220022222
033300003330
222222222222
001100001100
110003300011
333311113333
111111111111
111111111111
222221122222
000000000000
000000000000
000000000000