029655296-mountains-landscape.jpg
255, 0, 255, 255
53, 53, 255, 255
0, 255, 255, 255
128, 255, 0, 255
255, 128, 64, 255
Colormap
000000000000
000000000000
111100001111
000000000000
002222222200
000000000000
333300003333
000000000000
000000000000
001111111100
000000000000
000000000000
000000000000
Brickmap
000000000000
000000000000
111100001111
000000000000
002222222200
000000000000
333300003333
000000000000
000000000000
001111111100
000000000000
000000000000
000000000000