029655296-mountains-landscape.jpg
255, 0, 255, 255
53, 53, 255, 255
0, 255, 255, 255
128, 255, 0, 255
255, 128, 64, 255
Colormap
333333333333
333333333333
222222222222
222222222222
333333333333
333333333333
222222222222
222222222222
111111111111
111111111111
111111111111
111111111111
000000000000
Brickmap
000000000000
000000000000
222220000000
222220000000
000000011111
000000011111
111110000000
111110000000
000000022222
000000022222
000000000000
000000000000
000000000000