029655296-mountains-landscape.jpg
255, 0, 255, 255
53, 53, 255, 255
0, 255, 255, 255
128, 255, 0, 255
255, 128, 64, 255
Colormap
000000000000
001100001100
330033330033
330033330033
333333333333
110000000011
333333333333
000211112000
000211112000
022211112220
000000000000
000000000000
000000000000
Brickmap
000000000000
001100001100
330033330033
330033330033
333333333333
110000000011
333333333333
000211112000
000211112000
022211112220
000000000000
000000000000
000000000000