029655296-mountains-landscape.jpg
255, 0, 255, 255
53, 53, 255, 255
0, 255, 255, 255
128, 255, 0, 255
255, 128, 64, 255
Colormap
002111111200
002211112200
000221122000
000000000000
333333333333
221100001122
002110011200
000211112000
000021120000
000002200000
000000000000
000000000000
000000000000
Brickmap
002111111200
002211112200
000221122000
000000000000
333333333333
221100001122
002110011200
000211112000
000021120000
000002200000
000000000000
000000000000
000000000000