029655296-mountains-landscape.jpg
255, 0, 255, 255
53, 53, 255, 255
0, 255, 255, 255
128, 255, 0, 255
255, 128, 64, 255
Colormap
330033330033
001100001100
002120002120
021112021112
000333333000
110010010011
222222222222
110010010011
333311111133
333333333333
001100001100
000000000000
000000000000
Brickmap
330033330033
001100001100
002120002120
021112021112
000333333000
110010010011
222222222222
110010010011
333311111133
333333333333
001100001100
000000000000
000000000000