040892815-fantastic-landscape.jpg
255, 128, 192, 255
53, 53, 255, 255
128, 128, 0, 255
128, 255, 128, 255
255, 0, 0, 255
Colormap
000000000000
120000000000
012000000000
001233000000
000123300000
000012330000
000001233000
000000120000
000000012000
000000001200
000000000120
000000000000
000000000000
Brickmap
000000000000
120000000000
012000000000
001233000000
000123300000
000012330000
000001233000
000000123000
000000012000
000000001200
000000000120
000000000000
000000000000