040892815-fantastic-landscape.jpg
255, 128, 192, 255
53, 53, 255, 255
128, 128, 0, 255
128, 255, 128, 255
255, 0, 0, 255
Colormap
010101010101
222220022222
222200002222
222000000222
200000000002
111111111111
333003300333
333003300333
000000000000
000022220000
111111111111
000000000000
000000000000
Brickmap
010101010101
222220022222
222200002222
222000000222
200000000002
111111111111
333003300333
333003300333
000000000000
000022220000
111111111111
000000000000
000000000000