040892815-fantastic-landscape.jpg
255, 128, 192, 255
53, 53, 255, 255
128, 128, 0, 255
128, 255, 128, 255
255, 0, 0, 255
Colormap
022002200220
022000000220
022000000220
022003300220
022003300220
022003300220
122100000001
110000000011
100000001221
000000122221
000012222221
000000000000
000000000000
Brickmap
022002200220
022000000220
022000000220
022003300220
022003300220
022003300220
122100000001
110000000011
100000001221
000000122221
000012222221
000000000000
000000000000