040892815-fantastic-landscape.jpg
255, 128, 192, 255
53, 53, 255, 255
128, 128, 0, 255
128, 255, 128, 255
255, 0, 0, 255
Colormap
222000000222
200000000002
333333333333
200000000002
222000000222
000022220000
000022220000
220000000022
333333333333
000022220000
111111111111
000000000000
000000000000
Brickmap
222000000222
200000000002
333333333333
200000000002
222000000222
000022220000
000022220000
220000000022
333333333333
000022220000
111111111111
000000000000
000000000000