040892815-fantastic-landscape.jpg
255, 128, 192, 255
53, 53, 255, 255
128, 128, 0, 255
128, 255, 128, 255
255, 0, 0, 255
Colormap
000000000000
000022220000
220000000022
222002200222
111110011111
222220022222
000000000000
000211112000
000211112000
022211112220
222222222222
000000000000
000000000000
Brickmap
000000000000
000022220000
220000000022
222002200222
111110011111
222220022222
000000000000
000211112000
000211112000
022211112220
222222222222
000000000000
000000000000