040892815-fantastic-landscape.jpg
255, 128, 192, 255
53, 53, 255, 255
128, 128, 0, 255
128, 255, 128, 255
255, 0, 0, 255
Colormap
000000000000
003330033300
111001100111
222002200222
333311111333
111111113333
222000000222
200000000002
222220022222
002202202200
020020020020
000000000000
000000000000
Brickmap
000000000000
003330033300
111001100111
222002200222
333311111333
111111113333
222000000222
200000000002
222220022222
002202202200
020020020020
000000000000
000000000000