040892815-fantastic-landscape.jpg
255, 128, 192, 255
53, 53, 255, 255
128, 128, 0, 255
128, 255, 128, 255
255, 0, 0, 255
Colormap
000000000000
033300003330
000033330000
033300003330
222200002222
222200002222
020200002020
020200002020
020200002020
022003300220
022003300220
000000000000
000000000000
Brickmap
000000000000
033300003330
000033330000
033300003330
222200002222
222200002222
020200002020
020200002020
020200002020
022003300220
022003300220
000000000000
000000000000