040892815-fantastic-landscape.jpg
255, 128, 192, 255
53, 53, 255, 255
128, 128, 0, 255
128, 255, 128, 255
255, 0, 0, 255
Colormap
333330000000
000000011111
333330000000
000000011111
222220000000
000000022222
222220000000
000000011111
333330000000
000000033333
111110000000
000000000000
000000000000
Brickmap
333330000000
000000011111
333330000000
000000011111
222220000000
000000022222
222220000000
000000011111
333330000000
000000033333
111110000000
000000000000
000000000000