040892815-fantastic-landscape.jpg
255, 128, 192, 255
53, 53, 255, 255
128, 128, 0, 255
128, 255, 128, 255
255, 0, 0, 255
Colormap
000000000000
000000000000
000000000000
110000000011
222000000222
222200002222
222220022222
222220022222
222200002222
222000000222
110000000011
000000000000
000000000000
Brickmap
000000000000
000000000000
000000000000
110000000011
222000000222
222200002222
222220022222
222220022222
222200002222
222000000222
110000000011
000000000000
000000000000