040892815-fantastic-landscape.jpg
255, 128, 192, 255
53, 53, 255, 255
128, 128, 0, 255
128, 255, 128, 255
255, 0, 0, 255
Colormap
111110011111
222220022222
000111111000
030302020200
303030202020
030303020202
203030302020
022002200220
000022220000
002222222200
222222222222
000000000000
000000000000
Brickmap
111110011111
222220022222
000111111000
030302020200
303030202020
030303020202
203030302020
022002200220
000022220000
002222222200
222222222222
000000000000
000000000000