040892815-fantastic-landscape.jpg
255, 128, 192, 255
53, 53, 255, 255
128, 128, 0, 255
128, 255, 128, 255
255, 0, 0, 255
Colormap
111001100111
222002200222
333330033333
003333333300
000333333000
002222222200
000021112000
000002220000
000200200200
002120002120
021112021112
000000000000
000000000000
Brickmap
111001100111
222002200222
333330033333
003333333300
000333333000
002222222200
000021112000
000002220000
000200200200
002120002120
021112021112
000000000000
000000000000