040892815-fantastic-landscape.jpg
255, 128, 192, 255
53, 53, 255, 255
128, 128, 0, 255
128, 255, 128, 255
255, 0, 0, 255
Colormap
000000000000
222002200222
000220022000
222222222222
333003300333
333003300333
333003300333
033300003330
022200002220
222220022222
111100001111
000000000000
000000000000
Brickmap
000000000000
222002200222
000220022000
222222222222
333003300333
333003300333
333003300333
033300003330
022200002220
222220022222
111100001111
000000000000
000000000000