040892807-fantastic-landscape.jpg
255, 255, 128, 255
53, 53, 255, 255
0, 64, 128, 255
128, 0, 64, 255
255, 128, 192, 255
Colormap
110000000011
333333333333
001111111100
000333333000
022211112220
021111111120
021111111120
021111111120
000333333000
002222222200
033300003330
000000000000
000000000000
Brickmap
110000000011
333333333333
001111111100
000333333000
022211112220
021111111120
021111111120
021111111120
000333333000
002222222200
033300003330
000000000000
000000000000