040892807-fantastic-landscape.jpg
255, 255, 128, 255
53, 53, 255, 255
0, 64, 128, 255
128, 0, 64, 255
255, 128, 192, 255
Colormap
000000000000
111111111111
222222222222
333333333333
000000000000
000000000000
000000000000
333333333333
222222222222
111111111111
000000000000
000000000000
000000000000
Brickmap
000000000000
111111111111
222222222222
333333333333
000000000000
000000000000
000000000000
333333333333
222222222222
111111111111
000000000000
000000000000
000000000000