040892807-fantastic-landscape.jpg
255, 255, 128, 255
53, 53, 255, 255
0, 64, 128, 255
128, 0, 64, 255
255, 128, 192, 255
Colormap
222000000000
222222000000
221112222000
221111112222
222222222222
000000000333
000000333333
000333311133
333311111133
333333333333
000000000000
000000000000
000000000000
Brickmap
222000000000
222222000000
221112222000
221111112222
222222222222
000000000333
000000333333
000333311133
333311111133
333333333333
000000000000
000000000000
000000000000