040892807-fantastic-landscape.jpg
255, 255, 128, 255
53, 53, 255, 255
0, 64, 128, 255
128, 0, 64, 255
255, 128, 192, 255
Colormap
222222222222
110000000011
001100001100
222222222222
222000000222
330033330033
330033330033
001100001100
002120002120
021112021112
000333333000
000000000000
000000000000
Brickmap
222222222222
110000000011
001100001100
222222222222
222000000222
330033330033
330033330033
001100001100
002120002120
021112021112
000333333000
000000000000
000000000000