040892807-fantastic-landscape.jpg
255, 255, 128, 255
53, 53, 255, 255
0, 64, 128, 255
128, 0, 64, 255
255, 128, 192, 255
Colormap
222200002222
222000000222
110000000011
111001100111
222002200222
033300003330
002222222200
002211112200
002211112200
002222222200
000000000000
000000000000
000000000000
Brickmap
222200002222
222000000222
110000000011
111001100111
222002200222
033300003330
002222222200
002211112200
002211112200
002222222200
000000000000
000000000000
000000000000