040892807-fantastic-landscape.jpg
255, 255, 128, 255
53, 53, 255, 255
0, 64, 128, 255
128, 0, 64, 255
255, 128, 192, 255
Colormap
000000000000
111001100111
222002200222
000220022000
000003111111
000031111111
333311111333
111111113333
111111130000
111111300000
000000000000
000000000000
000000000000
Brickmap
000000000000
111001100111
222002200222
000220022000
000003111111
000031111111
333311111333
111111113333
111111130000
111111300000
000000000000
000000000000
000000000000