040892807-fantastic-landscape.jpg
255, 255, 128, 255
53, 53, 255, 255
0, 64, 128, 255
128, 0, 64, 255
255, 128, 192, 255
Colormap
002222222200
222200002222
222220022222
333333333333
222220022222
222200002222
330033330033
330033330033
001100001100
022222222220
010010010010
000000000000
000000000000
Brickmap
002222222200
222200002222
222220022222
333333333333
222220022222
222200002222
330033330033
330033330033
001100001100
022222222220
010010010010
000000000000
000000000000