040892807-fantastic-landscape.jpg
255, 255, 128, 255
53, 53, 255, 255
0, 64, 128, 255
128, 0, 64, 255
255, 128, 192, 255
Colormap
000311113000
000311113000
333311113333
000033330000
000311113000
000033330000
000221122000
000022220000
111002200111
221100001122
022110011220
000000000000
000000000000
Brickmap
000311113000
000311113000
333311113333
000033330000
000311113000
000033330000
000221122000
000022220000
111002200111
221100001122
022110011220
000000000000
000000000000