040892807-fantastic-landscape.jpg
255, 255, 128, 255
53, 53, 255, 255
0, 64, 128, 255
128, 0, 64, 255
255, 128, 192, 255
Colormap
000000000000
111100001111
330000000033
333000000333
222220022222
033300003330
022200002220
222220022222
111100001111
330000000033
333000000333
000000000000
000000000000
Brickmap
000000000000
111100001111
330000000033
333000000333
222220022222
033300003330
022200002220
222220022222
111100001111
330000000033
333000000333
000000000000
000000000000