040892807-fantastic-landscape.jpg
255, 255, 128, 255
53, 53, 255, 255
0, 64, 128, 255
128, 0, 64, 255
255, 128, 192, 255
Colormap
222221122222
333321123333
000321123000
000321123000
000322223000
000333333000
000211112000
000211112000
022211112220
021111111120
111110011111
000000000000
000000000000
Brickmap
222221122222
333321123333
000321123000
000321123000
000322223000
000333333000
000211112000
000211112000
022211112220
021111111120
111110011111
000000000000
000000000000