040892807-fantastic-landscape.jpg
255, 255, 128, 255
53, 53, 255, 255
0, 64, 128, 255
128, 0, 64, 255
255, 128, 192, 255
Colormap
001100001100
021200002120
222200002222
000000000000
021111111120
021111111120
021111111120
033333333330
222200002222
222220022222
330033330033
000000000000
000000000000
Brickmap
001100001100
021200002120
222200002222
000000000000
021111111120
021111111120
021111111120
033333333330
222200002222
222220022222
330033330033
000000000000
000000000000