040892807-fantastic-landscape.jpg
255, 255, 128, 255
53, 53, 255, 255
0, 64, 128, 255
128, 0, 64, 255
255, 128, 192, 255
Colormap
000000000000
110010010011
110010010011
002202202200
020020020020
222222222222
110010010011
110010010011
001110011100
111011110111
222022220222
000000000000
000000000000
Brickmap
000000000000
110010010011
110010010011
002202202200
020020020020
222222222222
110010010011
110010010011
001110011100
111011110111
222022220222
000000000000
000000000000