038904975-dying-world.jpg
0, 0, 255, 255
128, 0, 128, 255
145, 0, 0, 255
255, 255, 0, 255
128, 128, 0, 255
Colormap
111111111111
111111111111
333333333333
333333333333
333333333333
111111111111
111111111111
333333333333
333333333333
333333333333
111111111111
111111111111
111111111111
Brickmap
111111111111
111111111111
333003300333
333003300333
333003300333
111111111111
111111111111
333003300333
333003300333
333003300333
000000000000
000000000000
000000000000