038904975-dying-world.jpg
0, 0, 255, 255
128, 0, 128, 255
145, 0, 0, 255
255, 255, 0, 255
128, 128, 0, 255
Colormap
000000033333
000000311111
000003111111
000031111111
333311111333
111111113333
111111130000
111111300000
111113000000
111130000000
333300000000
000000000000
000000000000
Brickmap
000000033333
000000311111
000003111111
000031111111
333311111333
111111113333
111111130000
111111300000
111113000000
111130000000
333300000000
000000000000
000000000000