038904975-dying-world.jpg
0, 0, 255, 255
128, 0, 128, 255
145, 0, 0, 255
255, 255, 0, 255
128, 128, 0, 255
Colormap
333333333333
333311113333
333333333333
333333333333
333333333333
333333333333
111111111111
111111111111
111111111111
111111111111
111111111111
111111111111
111111111111
Brickmap
000011110000
000110011000
003300003300
003300003300
003300003300
000333333000
222222222222
011111111110
001111111100
000111111000
000011110000
000000000000
000000000000