038904975-dying-world.jpg
0, 0, 255, 255
128, 0, 128, 255
145, 0, 0, 255
255, 255, 0, 255
128, 128, 0, 255
Colormap
222222222222
222222222222
222222222222
222222222222
222222222222
333333333333
333333333333
222222222222
111111111111
333333333333
333333333333
222222222222
000000000000
Brickmap
000000000000
000000000000
000000000000
000000000000
000000000000
101010101010
111111111111
111111111111
010101010101
000000000000
000000000000
000000000000
000000000000