038904975-dying-world.jpg
0, 0, 255, 255
128, 0, 128, 255
145, 0, 0, 255
255, 255, 0, 255
128, 128, 0, 255
Colormap
033001100330
033001100330
033001100330
000001100000
000001100000
011001100110
011000000110
011000000110
011003300110
011003300110
011003300110
111111111111
111111111111
Brickmap
033002200330
033002200330
033002200330
000002200000
000002200000
022002200220
022000000220
022000000220
022003300220
022003300220
022003300220
000000000000
000000000000