038904975-dying-world.jpg
0, 0, 255, 255
128, 0, 128, 255
145, 0, 0, 255
255, 255, 0, 255
128, 128, 0, 255
Colormap
111111111111
122222222100
122222210000
122221000000
122100000001
110000000011
100000001221
000000122221
000012222221
001222222221
111111111111
111111111111
111111111111
Brickmap
111111111111
122222222100
122222210000
122221000000
122100000001
110000000011
100000001221
000000122221
000012222221
001222222221
111111111111
000000000000
000000000000