038904975-dying-world.jpg
0, 0, 255, 255
128, 0, 128, 255
145, 0, 0, 255
255, 255, 0, 255
128, 128, 0, 255
Colormap
110000000011
222000000222
222200002222
222220022222
111111111111
222220022222
222200002222
222000000222
110000000011
001111111100
000011110000
000000000000
000000000000
Brickmap
110000000011
222000000222
222200002222
222220022222
333333333333
222220022222
222200002222
222000000222
110000000011
003333333300
000033330000
000000000000
000000000000