038904975-dying-world.jpg
0, 0, 255, 255
128, 0, 128, 255
145, 0, 0, 255
255, 255, 0, 255
128, 128, 0, 255
Colormap
111111111111
111111111111
111111111111
111111111111
111111111111
111111111111
111111111111
122222222221
122222222221
322222222221
111111111111
111111111111
111111111111
Brickmap
222200002222
222200002222
020200002020
020200002020
020200002020
000000000000
333333333333
322222222223
322222222223
322222222223
333333333333
000000000000
000000000000