038904975-dying-world.jpg
0, 0, 255, 255
128, 0, 128, 255
145, 0, 0, 255
255, 255, 0, 255
128, 128, 0, 255
Colormap
222222222222
221112211122
222222222222
111111111111
111111111111
222222222222
221112211122
222222222222
111111111111
111111111111
111111111111
111111111111
111111111111
Brickmap
000000000000
000000000000
022222222220
021112211120
022222222220
000011110000
000011110000
022222222220
021112211120
022222222220
000000000000
000000000000
000000000000
