038904975-dying-world.jpg
0, 0, 255, 255
128, 0, 128, 255
145, 0, 0, 255
255, 255, 0, 255
128, 128, 0, 255
Colormap
000000222222
000000222222
000000222222
111110000000
111110000000
111110000000
000000222222
000000222222
111110000000
111110000000
000000000000
000000000000
000000000000
Brickmap
000000222222
000000222222
000000222222
111110000000
111110000000
111110000000
000000333333
000000333333
333330000000
333330000000
000000000000
000000000000
000000000000