038904975-dying-world.jpg
0, 0, 255, 255
128, 0, 128, 255
145, 0, 0, 255
255, 255, 0, 255
128, 128, 0, 255
Colormap
002222222200
002211112200
002211112200
002222222200
033300003330
000033330000
033300003330
002222222200
002211112200
002211112200
002222222200
000000000000
000000000000
Brickmap
002222222200
002211112200
002211112200
002222222200
033300003330
000033330000
033300003330
002222222200
002211112200
002211112200
002222222200
000000000000
000000000000