255, 255, 255, 255
0, 0, 0, 255
0, 237, 255, 255
0, 144, 255, 255
0, 59, 255, 255
Colormap
333333333333
333333333333
333333333333
000000000000
222220022222
222220022222
222220022222
000000000000
111110011111
111110011111
111110011111
000000000000
000000000000
Brickmap
111111111111
111111111111
222222222222
000000000000
111110011111
111110011111
222220022222
000000000000
111110011111
111110011111
333330033333
000000000000
000000000000
