shutterstock12.png
255, 128, 128, 255
0, 0, 0, 255
159, 240, 255, 255
0, 148, 255, 255
Colormap
111111111111
222222222222
111111111111
222222222222
111111111111
222222222222
111111111111
222222222222
111111111111
222222222222
111111111111
222222222222
111111111111
Brickmap
000311113000
000311113000
333311113333
111111111111
111111111111
222221122222
333321123333
000321123000
000321123000
000322223000
000333333000
000000000000
000000000000
