0, 255, 255, 255
0, 0, 0, 255
217, 56, 62, 255
132, 56, 62, 255
Colormap
111111111111
111111111111
222211112222
000211112000
000211112000
022211112220
021111111120
021111111120
021111111120
022222222220
000000000000
000000000000
000000000000
Brickmap
111111111111
111111111111
222211112222
000211112000
000211112000
022211112220
021111111120
021111111120
021111111120
033333333330
000000000000
000000000000
000000000000
