0, 255, 0, 255
0, 0, 0, 255
255, 221, 0, 255
255, 0, 0, 255
Colormap
222220022222
222220022222
222220022222
222220022222
000000000000
111111111111
111111111111
000000000000
111111111111
111111111111
000000000000
000000000000
000000000000
Brickmap
111110011111
111110011111
111110011111
222220022222
000000000000
111111111111
333333333333
000000000000
111111111111
222222222222
000000000000
000000000000
000000000000
