shutterstock8.png
255, 0, 0, 255
0, 0, 255, 255
128, 128, 64, 255
255, 170, 192, 255
111, 255, 183, 255
Colormap
111110011111
111110011111
111110011111
222220022222
000000000000
111111111111
003300003300
003300003300
003300003300
003300003300
003300003300
000000000000
000000000000
Brickmap
111110011111
111110011111
111110011111
222220022222
000000000000
111111111111
003300003300
003300003300
003300003300
003300003300
003300003300
000000000000
000000000000