shutterstock8.png
255, 0, 0, 255
0, 0, 255, 255
128, 128, 64, 255
255, 170, 192, 255
111, 255, 183, 255
Colormap
000000000000
333333333333
000000000000
002220022200
000000000000
333333333333
000000000000
222200002222
000022220000
000033333330
000000000000
000000000000
000000000000
Brickmap
000000000000
111111111111
000000000000
002220022200
000000000000
111111111111
000000000000
222200002222
000022220000
000011110000
000000000000
000000000000
000000000000