shutterstock8.png
255, 0, 0, 255
0, 0, 255, 255
128, 128, 64, 255
255, 170, 192, 255
111, 255, 183, 255
Colormap
222000000222
200000000002
222220022222
003330033300
111001100111
222002200222
333311111333
111111113333
111111130000
002202202200
020020020020
000000000000
000000000000
Brickmap
222000000222
200000000002
222220022222
003330033300
111001100111
222002200222
333311111333
111111113333
111111130000
002202202200
020020020020
000000000000
000000000000