shutterstock8.png
255, 0, 0, 255
0, 0, 255, 255
128, 128, 64, 255
255, 170, 192, 255
111, 255, 183, 255
Colormap
111111111111
333003300333
333003300333
000000000000
000022220000
333333333333
111111111111
010101010101
222220022222
222200002222
222000000222
200000000002
000000000000
Brickmap
111111111111
333003300333
333003300333
000000000000
000022220000
333333333333
111111111111
010101010101
222220022222
222200002222
222000000222
200000000002
000000000000