shutterstock8.png
255, 0, 0, 255
0, 0, 255, 255
128, 128, 64, 255
255, 170, 192, 255
111, 255, 183, 255
Colormap
000000033330
000000033330
033330000000
033330000000
000000000000
000011110000
333000000333
003000000300
111111111111
001100000110
033330033330
000000000000
000000000000
Brickmap
000000033330
000000033330
033330000000
033330000000
000000000000
000011110000
333000000333
003000000300
111111111111
001100000110
033330033330
000000000000
000000000000