shutterstock8.png
255, 0, 0, 255
0, 0, 255, 255
128, 128, 64, 255
255, 170, 192, 255
111, 255, 183, 255
Colormap
222002200222
000220022000
222222222222
333003300333
333003300333
333003300333
111110000000
111110000000
111110000000
000022220000
220000000022
000000000000
000000000000
Brickmap
222002200222
000220022000
222222222222
333003300333
333003300333
333003300333
111110000000
111110000000
111110000000
000022220000
220000000022
000000000000
000000000000