shutterstock8.png
255, 0, 0, 255
0, 0, 255, 255
128, 128, 64, 255
255, 170, 192, 255
111, 255, 183, 255
Colormap
111110011111
222220022222
000000000000
000211112000
000211112000
022211112220
222222222222
110010010011
111111300000
111113000000
111130000000
000000000000
000000000000
Brickmap
111110011111
222220022222
000000000000
000211112000
000211112000
022211112220
222222222222
110010010011
111111300000
111113000000
111130000000
000000000000
000000000000