shutterstock8.png
255, 0, 0, 255
0, 0, 255, 255
128, 128, 64, 255
255, 170, 192, 255
111, 255, 183, 255
Colormap
222220022222
033300003330
022200002220
222220022222
111100001111
330000000033
333000000333
000000122221
000012222221
001222222221
111111111111
000000000000
000000000000
Brickmap
222220022222
033300003330
022200002220
222220022222
111100001111
330000000033
333000000333
000000122221
000012222221
001222222221
111111111111
000000000000
000000000000