shutterstock8.png
255, 0, 0, 255
0, 0, 255, 255
128, 128, 64, 255
255, 170, 192, 255
111, 255, 183, 255
Colormap
111100001111
330000000033
333000000333
222220022222
333333333333
222220022222
222200002222
222000000222
110000000011
111001100111
222002200222
000000000000
000000000000
Brickmap
111100001111
330000000033
333000000333
222220022222
333333333333
222220022222
222200002222
222000000222
110000000011
111001100111
222002200222
000000000000
000000000000