shutterstock8.png
255, 0, 0, 255
0, 0, 255, 255
128, 128, 64, 255
255, 170, 192, 255
111, 255, 183, 255
Colormap
000022220000
220000000022
333333333333
000000000000
020020020020
333330000000
000000033333
333001111111
000333001111
000000333001
000000000333
000000000000
000000000000
Brickmap
000022220000
220000000022
333333333333
000000000000
020020020020
333330000000
000000033333
333001111111
000333001111
000000333001
000000000333
000000000000
000000000000