shutterstock8.png
255, 0, 0, 255
0, 0, 255, 255
128, 128, 64, 255
255, 170, 192, 255
111, 255, 183, 255
Colormap
000333333000
000333333000
000111111000
000111111000
000000000000
111111111111
111001100111
222002200222
000220022000
222222222222
003300003300
000000000000
000000000000
Brickmap
000333333000
000333333000
000111111000
000111111000
000000000000
111111111111
111001100111
222002200222
000220022000
222222222222
003300003300
000000000000
000000000000