shutterstock8.png
255, 0, 0, 255
0, 0, 255, 255
128, 128, 64, 255
255, 170, 192, 255
111, 255, 183, 255
Colormap
000000200000
000002120000
000021112000
000211111200
000021112000
000002220000
000200200200
002120002120
021112021112
002120002120
000200000200
000000000000
000000000000
Brickmap
000000200000
000002120000
000021112000
000211111200
000021112000
000002220000
000200200200
002120002120
021112021112
002120002120
000200000200
000000000000
000000000000