255, 0, 0, 255
0, 0, 0, 255
0, 255, 255, 255
7, 255, 189, 255
Colormap
111111111111
222222222222
111111111111
222222222222
111111111111
222222222222
111111111111
222222222222
111111111111
222222222222
111111111111
222222222222
000000000000
Brickmap
111011110111
111011110111
222022220222
000000000000
111011110111
222022220222
000000000000
111000000111
222000000222
000000000000
222222222222
000000000000
000000000000
