081085895-flying-over-mountains-sunny-da.jpg
128, 0, 128, 255
53, 53, 255, 255
255, 128, 128, 255
128, 255, 255, 255
255, 255, 128, 255
Colormap
000000000000
111110011111
222220022222
111111111111
333333333333
000000000000
111111111111
302020200333
030202020033
000000000000
000000000000
000000000000
000000000000
Brickmap
000000000000
111110011111
222220022222
111111111111
333333333333
000000000000
111111111111
302020200333
030202020033
000000000000
000000000000
000000000000
000000000000