081085895-flying-over-mountains-sunny-da.jpg
128, 0, 128, 255
53, 53, 255, 255
255, 128, 128, 255
128, 255, 255, 255
255, 255, 128, 255
Colormap
111111111111
333000000333
000333333000
333000000333
333333333333
220000000022
002200002200
000022220000
021111111120
000011110000
022222222220
000000000000
000000000000
Brickmap
111111111111
333000000333
000333333000
333000000333
333333333333
220000000022
002200002200
000022220000
021111111120
000011110000
022222222220
000000000000
000000000000