081085895-flying-over-mountains-sunny-da.jpg
128, 0, 128, 255
53, 53, 255, 255
255, 128, 128, 255
128, 255, 255, 255
255, 255, 128, 255
Colormap
000000000000
000000000000
000000000000
212121212121
000003300000
000003300000
002220022200
002220022200
000011110000
000000000000
000000000000
000000000000
000000000000
Brickmap
000000000000
000000000000
000000000000
212121212121
000003300000
000003300000
002220022200
002220022200
000011110000
000000000000
000000000000
000000000000
000000000000