081085895-flying-over-mountains-sunny-da.jpg
128, 0, 128, 255
53, 53, 255, 255
255, 128, 128, 255
128, 255, 255, 255
255, 255, 128, 255
Colormap
000000000000
000000000000
000000000000
003022222222
000300222222
000030002222
110003000022
111100300000
111111030000
111111113000
000000000000
000000000000
000000000000
Brickmap
000000000000
000000000000
000000000000
003022222222
000300222222
000030002222
110003000022
111100300000
111111030000
111111113000
000000000000
000000000000
000000000000