081085895-flying-over-mountains-sunny-da.jpg
128, 0, 128, 255
53, 53, 255, 255
255, 128, 128, 255
128, 255, 255, 255
255, 255, 128, 255
Colormap
000000000000
001100110011
330000000033
333000000333
222220022222
333333333333
222220022222
033300003330
000022220000
002222222200
000000000000
000000000000
000000000000
Brickmap
000000000000
001100110011
330000000033
333000000333
222220022222
333333333333
222220022222
033300003330
000022220000
002222222200
000000000000
000000000000
000000000000