081085895-flying-over-mountains-sunny-da.jpg
128, 0, 128, 255
53, 53, 255, 255
255, 128, 128, 255
128, 255, 255, 255
255, 255, 128, 255
Colormap
002200002200
000311113000
333311113333
111111111111
010010010010
020020020020
021112211120
002200002200
000022220000
000022220000
000000000000
000000000000
000000000000
Brickmap
002200002200
000311113000
333311113333
111111111111
010010010010
020020020020
021112211120
002200002200
000022220000
000022220000
000000000000
000000000000
000000000000