081085895-flying-over-mountains-sunny-da.jpg
128, 0, 128, 255
53, 53, 255, 255
255, 128, 128, 255
128, 255, 255, 255
255, 255, 128, 255
Colormap
000211112000
000211112000
022211112220
021111111120
000011110000
022222222220
000022220000
003303303300
002200002200
022330033220
002233332200
000000000000
000000000000
Brickmap
000211112000
000211112000
022211112220
021111111120
000011110000
022222222220
000022220000
003303303300
002200002200
022330033220
002233332200
000000000000
000000000000