081085895-flying-over-mountains-sunny-da.jpg
128, 0, 128, 255
53, 53, 255, 255
255, 128, 128, 255
128, 255, 255, 255
255, 255, 128, 255
Colormap
002222222200
222200002222
222220022222
330033330033
001100001100
002120002120
222200000000
222222000000
000000222222
000000002222
000000000000
000000000000
000000000000
Brickmap
002222222200
222200002222
222220022222
330033330033
001100001100
002120002120
222200000000
222222000000
000000222222
000000002222
000000000000
000000000000
000000000000