081085895-flying-over-mountains-sunny-da.jpg
128, 0, 128, 255
53, 53, 255, 255
255, 128, 128, 255
128, 255, 255, 255
255, 255, 128, 255
Colormap
000000000000
330033330033
330033330033
001100001100
022222222220
010010010010
010010010010
333000002223
000000222003
021120021120
000000000000
000000000000
000000000000
Brickmap
000000000000
330033330033
330033330033
001100001100
022222222220
010010010010
010010010010
333000002223
000000222003
021120021120
000000000000
000000000000
000000000000