081085895-flying-over-mountains-sunny-da.jpg
128, 0, 128, 255
53, 53, 255, 255
255, 128, 128, 255
128, 255, 255, 255
255, 255, 128, 255
Colormap
000000000000
002222222200
002211112200
002211112200
002222222200
000330033000
000033330000
000001100000
333003300333
111110000000
111110000000
000000000000
000000000000
Brickmap
000000000000
002222222200
002211112200
002211112200
002222222200
000330033000
000033330000
000001100000
333003300333
111110000000
111110000000
000000000000
000000000000