081085895-flying-over-mountains-sunny-da.jpg
128, 0, 128, 255
53, 53, 255, 255
255, 128, 128, 255
128, 255, 255, 255
255, 255, 128, 255
Colormap
000000000000
033333333330
000033330000
333000000333
001110011100
001110011100
001110011100
220002200022
220002200022
220002200022
000000000000
000000000000
000000000000
Brickmap
000000000000
033333333330
000033330000
333000000333
001110011100
001110011100
001110011100
220002200022
220002200022
220002200022
000000000000
000000000000
000000000000