081085895-flying-over-mountains-sunny-da.jpg
128, 0, 128, 255
53, 53, 255, 255
255, 128, 128, 255
128, 255, 255, 255
255, 255, 128, 255
Colormap
000000000000
000000000000
322222222223
322222222223
000000000000
110003300011
003330033300
000033330000
003303303300
000330033000
000033330000
000000000000
000000000000
Brickmap
000000000000
000000000000
322222222223
322222222223
000000000000
110003300011
003330033300
000033330000
003303303300
000330033000
000033330000
000000000000
000000000000