053070150-moon-landscape.jpg
0, 255, 0, 255
128, 0, 128, 255
255, 255, 128, 255
255, 128, 128, 255
0, 0, 255, 255
Colormap
000000000333
000000333333
000333322233
333322222233
333333333333
222000000000
222222000000
223332222000
223333332222
222222222222
000000000000
000000000000
000000000000
Brickmap
000000000333
000000333333
000333311133
333311111133
333333333333
222000000000
222222000000
221112222000
221111112222
222222222222
000000000000
000000000000
000000000000