053070150-moon-landscape.jpg
0, 255, 0, 255
128, 0, 128, 255
255, 255, 128, 255
255, 128, 128, 255
0, 0, 255, 255
Colormap
000033330000
000311113000
000033330000
111000000111
011100001110
001110011100
000111111000
000000000000
111111111111
000333333000
000000000000
000000000000
000000000000
Brickmap
000033330000
000311113000
000033330000
111000000111
011100001110
001110011100
000111111000
000000000000
111111111111
000333333000
000000000000
000000000000
000000000000