053070150-moon-landscape.jpg
0, 255, 0, 255
128, 0, 128, 255
255, 255, 128, 255
255, 128, 128, 255
0, 0, 255, 255
Colormap
333333333333
222222222222
111111111111
333333333333
222222222222
111111111111
333333333333
222222222222
111111111111
333333333333
222222222222
111111111111
000000000000
Brickmap
333330000000
000000033333
333330000000
000000033333
333330000000
000000033333
333330000000
000000033333
333330000000
000000033333
333330000000
000000000000
000000000000