053070150-moon-landscape.jpg
0, 255, 0, 255
128, 0, 128, 255
255, 255, 128, 255
255, 128, 128, 255
0, 0, 255, 255
Colormap
222220022222
222200002222
222000000222
200000000002
333333333333
200000000002
222000000222
222200002222
222220022222
003330033300
000000000000
000000000000
000000000000
Brickmap
222220022222
222200002222
222000000222
200000000002
333333333333
200000000002
222000000222
222200002222
222220022222
003330033300
000000000000
000000000000
000000000000