053070150-moon-landscape.jpg
0, 255, 0, 255
128, 0, 128, 255
255, 255, 128, 255
255, 128, 128, 255
0, 0, 255, 255
Colormap
222222222222
222222222222
222222222222
000000000000
000000000333
000000333001
000333001111
333001111111
000333001111
000000333001
000000000333
000000000000
000000000000
Brickmap
111111000000
222222000000
222222000000
000000000000
000000000333
000000333001
000333001111
333001111111
000333001111
000000333001
000000000333
000000000000
000000000000