053070150-moon-landscape.jpg
0, 255, 0, 255
128, 0, 128, 255
255, 255, 128, 255
255, 128, 128, 255
0, 0, 255, 255
Colormap
020202003333
302020200333
030202020033
303020202003
030302020200
303030202020
030303020202
203030302020
220303030202
222030303020
222203030302
000000000000
000000000000
Brickmap
020202003333
302020200333
030202020033
303020202003
030302020200
303030202020
030303020202
203030302020
220303030202
222030303020
222203030302
000000000000
000000000000