053070150-moon-landscape.jpg
0, 255, 0, 255
128, 0, 128, 255
255, 255, 128, 255
255, 128, 128, 255
0, 0, 255, 255
Colormap
000000333033
200000330333
220000303333
222000033333
220000000000
200000000003
000000000033
222220000333
222202000033
222022000003
220222000000
000000000000
000000000000
Brickmap
000000333033
200000330333
220000303333
222000033333
220000000000
200000000003
000000000033
222220000333
222202000033
222022000003
220222000000
000000000000
000000000000