053070150-moon-landscape.jpg
0, 255, 0, 255
128, 0, 128, 255
255, 255, 128, 255
255, 128, 128, 255
0, 0, 255, 255
Colormap
220000000022
000022220000
000022220000
220000000022
333333333333
000022220000
333333333333
000000000000
001110000000
001110011100
000000011100
000000000000
000000000000
Brickmap
220000000022
000022220000
000022220000
220000000022
333333333333
000022220000
333333333333
000000000000
001110000000
001110011100
000000011100
000000000000
000000000000