053070150-moon-landscape.jpg
0, 255, 0, 255
128, 0, 128, 255
255, 255, 128, 255
255, 128, 128, 255
0, 0, 255, 255
Colormap
003333333300
220000000022
002200002200
000022220000
000022220000
002200002200
022330033220
002233332200
000223322000
000022220000
000002200000
000000000000
000000000000
Brickmap
003333333300
220000000022
002200002200
000022220000
000022220000
002200002200
022330033220
002233332200
000223322000
000022220000
000002200000
000000000000
000000000000