053070150-moon-landscape.jpg
0, 255, 0, 255
128, 0, 128, 255
255, 255, 128, 255
255, 128, 128, 255
0, 0, 255, 255
Colormap
000000000000
000000000000
000000000000
001110011100
111011110111
222022220222
000000000000
111001100111
222002200222
000220022000
222222222222
000000000000
000000000000
Brickmap
000000000000
000000000000
000000000000
001110011100
111011110111
222022220222
000000000000
111001100111
222002200222
000220022000
222222222222
000000000000
000000000000