053070150-moon-landscape.jpg
0, 255, 0, 255
128, 0, 128, 255
255, 255, 128, 255
255, 128, 128, 255
0, 0, 255, 255
Colormap
000000000000
110010010011
110010010011
110010010011
222222222222
110010010011
110010010011
110010010011
110010010011
002202202200
020020020020
000000000000
000000000000
Brickmap
000000000000
110010010011
110010010011
110010010011
222222222222
110010010011
110010010011
110010010011
110010010011
002202202200
020020020020
000000000000
000000000000