041515701-fantastic-landscape.jpg
128, 0, 128, 255
128, 0, 128, 255
0, 128, 192, 255
255, 0, 128, 255
255, 255, 155, 255
Colormap
000011110000
000333333000
000333333000
003303303300
000330033000
000033330000
000000001221
000000122221
000012222221
001222222221
111111111111
000000000000
000000000000
Brickmap
000011110000
000333333000
000333333000
003303303300
000330033000
000033330000
000000001221
000000122221
000012222221
001222222221
111111111111
000000000000
000000000000