041515701-fantastic-landscape.jpg
128, 0, 128, 255
128, 0, 128, 255
0, 128, 192, 255
255, 0, 128, 255
255, 255, 155, 255
Colormap
002200002200
000022220000
111001100111
222002200222
333330033333
003333333300
000333333000
002222222200
111110011111
222220022222
000111111000
000000000000
000000000000
Brickmap
002200002200
000022220000
111001100111
222002200222
333330033333
003333333300
000333333000
002222222200
111110011111
222220022222
000111111000
000000000000
000000000000