041515701-fantastic-landscape.jpg
128, 0, 128, 255
128, 0, 128, 255
0, 128, 192, 255
255, 0, 128, 255
255, 255, 155, 255
Colormap
000022200033
000000222003
333000002223
333000002223
001100001100
330033330033
330033330033
222210000000
122222210000
222222222222
011111111110
000000000000
000000000000
Brickmap
000022200033
000000222003
333000002223
333000002223
001100001100
330033330033
330033330033
222210000000
122222210000
222222222222
011111111110
000000000000
000000000000