041515701-fantastic-landscape.jpg
128, 0, 128, 255
128, 0, 128, 255
0, 128, 192, 255
255, 0, 128, 255
255, 255, 155, 255
Colormap
222000000000
000222000000
000000222000
111111000222
000000111111
000222000000
002222222200
000000111111
111111000000
000000222000
000000000000
000000000000
000000000000
Brickmap
222000000000
000222000000
000000222000
111111000222
000000111111
000222000000
002222222200
000000111111
111111000000
000000222000
000000000000
000000000000
000000000000