041515701-fantastic-landscape.jpg
128, 0, 128, 255
128, 0, 128, 255
0, 128, 192, 255
255, 0, 128, 255
255, 255, 155, 255
Colormap
001111000000
000000011110
100000000000
110000000000
001100001100
330033330033
330033330033
222221122222
021112211120
022222222220
000011110000
000000000000
000000000000
Brickmap
001111000000
000000011110
100000000000
110000000000
001100001100
330033330033
330033330033
222221122222
021112211120
022222222220
000011110000
000000000000
000000000000