041515701-fantastic-landscape.jpg
128, 0, 128, 255
128, 0, 128, 255
0, 128, 192, 255
255, 0, 128, 255
255, 255, 155, 255
Colormap
222222222222
011111111110
001100001100
330033330033
330033330033
001100001100
022222222220
000011110000
000011110000
022222222220
223322332233
000000000000
000000000000
Brickmap
222222222222
011111111110
001100001100
330033330033
330033330033
001100001100
022222222220
000011110000
000011110000
022222222220
223322332233
000000000000
000000000000