041515701-fantastic-landscape.jpg
128, 0, 128, 255
128, 0, 128, 255
0, 128, 192, 255
255, 0, 128, 255
255, 255, 155, 255
Colormap
000211112000
000211112000
022211112220
333333333333
113313313311
111111330000
111113300000
111133000000
000033333333
000001111111
000000111111
000000000000
000000000000
Brickmap
000211112000
000211112000
022211112220
333333333333
113313313311
111111330000
111113300000
111133000000
000033333333
000001111111
000000111111
000000000000
000000000000