041515701-fantastic-landscape.jpg
128, 0, 128, 255
128, 0, 128, 255
0, 128, 192, 255
255, 0, 128, 255
255, 255, 155, 255
Colormap
212121212121
000002331200
000011212121
333333333333
111111111111
010101010101
222220022222
000333333000
010010010010
333000002223
000212000212
000000000000
000000000000
Brickmap
212121212121
000002331200
000011212121
333333333333
111111111111
010101010101
222220022222
000333333000
010010010010
333000002223
000212000212
000000000000
000000000000