041515701-fantastic-landscape.jpg
128, 0, 128, 255
128, 0, 128, 255
0, 128, 192, 255
255, 0, 128, 255
255, 255, 155, 255
Colormap
220000000000
222200000000
222222000000
111111111111
111111111111
111111111111
333333333300
333333330000
333333000000
333300000000
000000000000
000000000000
000000000000
Brickmap
220000000000
222200000000
222222000000
000000222222
000000002222
000000000022
333333333300
333333330000
333333000000
333300000000
000000000000
000000000000
000000000000