041515701-fantastic-landscape.jpg
128, 0, 128, 255
128, 0, 128, 255
0, 128, 192, 255
255, 0, 128, 255
255, 255, 155, 255
Colormap
330000000033
333000000333
222220022222
333333333333
222220022222
222200002222
222000000222
000022220000
002222222200
222222222222
000033330000
000000000000
000000000000
Brickmap
330000000033
333000000333
222220022222
333333333333
222220022222
222200002222
222000000222
000022220000
002222222200
222222222222
000033330000
000000000000
000000000000