041515701-fantastic-landscape.jpg
128, 0, 128, 255
128, 0, 128, 255
0, 128, 192, 255
255, 0, 128, 255
255, 255, 155, 255
Colormap
000000000000
000000000000
001111000000
000000011110
100000000000
110000000000
333000002000
333300022200
333000002000
110000000000
100000000000
000000000000
000000000000
Brickmap
000000000000
000000000000
001111000000
000000011110
100000000000
110000000000
111000002000
111100022200
111000002000
110000000000
100000000000
000000000000
000000000000