041515701-fantastic-landscape.jpg
128, 0, 128, 255
128, 0, 128, 255
0, 128, 192, 255
255, 0, 128, 255
255, 255, 155, 255
Colormap
110010010011
111111300000
222220000333
222202000033
222022000003
220222000000
030302020200
303030202020
030303020202
203030302020
022002200220
000000000000
000000000000
Brickmap
110010010011
111111300000
222220000333
222202000033
222022000003
220222000000
030302020200
303030202020
030303020202
203030302020
022002200220
000000000000
000000000000