058104293-red-planet-saturn-moon.jpg
0, 0, 128, 255
128, 0, 128, 255
183, 0, 183, 255
0, 151, 0, 255
210, 0, 105, 255
Colormap
222222222222
001100001100
110001100011
002220022200
222000222000
212000212000
222000222000
000222000222
000212000212
000222000222
000000000000
000000000000
000000000000
Brickmap
222222222222
001100001100
110001100011
002220022200
222000222000
212000212000
222000222000
000222000222
000212000212
000222000222
000000000000
000000000000
000000000000