058104293-red-planet-saturn-moon.jpg
0, 0, 128, 255
128, 0, 128, 255
183, 0, 183, 255
0, 151, 0, 255
210, 0, 105, 255
Colormap
111110000000
111110000000
000000333333
000000333333
002200002200
000022220000
000022220000
002200002200
000311113000
333311113333
111111111111
000000000000
000000000000
Brickmap
111110000000
111110000000
000000333333
000000333333
002200002200
000022220000
000022220000
002200002200
000311113000
333311113333
111111111111
000000000000
000000000000