058104293-red-planet-saturn-moon.jpg
0, 0, 128, 255
128, 0, 128, 255
183, 0, 183, 255
0, 151, 0, 255
210, 0, 105, 255
Colormap
222002200222
333330033333
003333333300
000333333000
002222222200
222200002222
222220022222
333333333333
222220022222
222200002222
232323323232
000000000000
000000000000
Brickmap
222002200222
333330033333
003333333300
000333333000
002222222200
222200002222
222220022222
333333333333
222220022222
222200002222
232323323232
000000000000
000000000000