058104293-red-planet-saturn-moon.jpg
0, 0, 128, 255
128, 0, 128, 255
183, 0, 183, 255
0, 151, 0, 255
210, 0, 105, 255
Colormap
222000222000
222222222222
011111111110
001111111100
000111111000
110010010011
222222222222
110010010011
000333333000
002222222200
111110011111
000000000000
000000000000
Brickmap
222000222000
222222222222
011111111110
001111111100
000111111000
110010010011
222222222222
110010010011
000333333000
002222222200
111110011111
000000000000
000000000000