058104293-red-planet-saturn-moon.jpg
0, 0, 128, 255
128, 0, 128, 255
183, 0, 183, 255
0, 151, 0, 255
210, 0, 105, 255
Colormap
222222222222
001100001100
110003300011
003330033300
000033330000
003303303300
000330033000
000033330000
000000001221
000000122221
000012222221
000000000000
000000000000
Brickmap
222222222222
001100001100
110003300011
003330033300
000033330000
003303303300
000330033000
000033330000
000000001221
000000122221
000012222221
000000000000
000000000000