058104293-red-planet-saturn-moon.jpg
0, 0, 128, 255
128, 0, 128, 255
183, 0, 183, 255
0, 151, 0, 255
210, 0, 105, 255
Colormap
333333333333
333333333333
333333333333
333333333333
333333333333
333333333333
333333333333
333333333333
333333333333
333333333333
333333333333
333333333333
000000000000
Brickmap
000000000000
000000000000
002200002200
022220022220
222222222222
222222222222
222222222222
222222222222
022222222220
000222222000
000002200000
000000000000
000000000000