058104293-red-planet-saturn-moon.jpg
0, 0, 128, 255
128, 0, 128, 255
183, 0, 183, 255
0, 151, 0, 255
210, 0, 105, 255
Colormap
000111111000
222220022222
033300003330
333311113333
111111111111
111111111111
222221122222
333321123333
222222222222
001100001100
110003300011
000000000000
000000000000
Brickmap
000111111000
222220022222
033300003330
333311113333
111111111111
111111111111
222221122222
333321123333
222222222222
001100001100
110003300011
000000000000
000000000000