058104293-red-planet-saturn-moon.jpg
0, 0, 128, 255
128, 0, 128, 255
183, 0, 183, 255
0, 151, 0, 255
210, 0, 105, 255
Colormap
000333333000
003333333300
011111111110
222222222222
333003300333
333003300333
111111111111
022200002220
222220022222
111100001111
330000000033
000000000000
000000000000
Brickmap
000333333000
003333333300
011111111110
222222222222
333003300333
333003300333
111111111111
022200002220
222220022222
111100001111
330000000033
000000000000
000000000000