058104293-red-planet-saturn-moon.jpg
0, 0, 128, 255
128, 0, 128, 255
183, 0, 183, 255
0, 151, 0, 255
210, 0, 105, 255
Colormap
222000000222
222000000222
222222222222
000333333000
000333333000
000111111000
000111111000
001100001100
330033330033
333333333333
000022220000
000000000000
000000000000
Brickmap
222000000222
222000000222
222222222222
000333333000
000333333000
000111111000
000111111000
001100001100
330033330033
333333333333
000022220000
000000000000
000000000000