058104293-red-planet-saturn-moon.jpg
0, 0, 128, 255
128, 0, 128, 255
183, 0, 183, 255
0, 151, 0, 255
210, 0, 105, 255
Colormap
000000000000
001100001100
330033330033
330033330033
001100001100
000000000000
222222222222
110000000011
001100001100
222222222222
222000000222
000000000000
000000000000
Brickmap
000000000000
001100001100
330033330033
330033330033
001100001100
000000000000
222222222222
110000000011
001100001100
222222222222
222000000222
000000000000
000000000000