058104293-red-planet-saturn-moon.jpg
0, 0, 128, 255
128, 0, 128, 255
183, 0, 183, 255
0, 151, 0, 255
210, 0, 105, 255
Colormap
000000000000
222220022222
033300003330
022200002220
222220022222
122221000000
122100000001
110000000011
100000001221
000000122221
000012222221
000000000000
000000000000
Brickmap
000000000000
222220022222
033300003330
022200002220
222220022222
122221000000
122100000001
110000000011
100000001221
000000122221
000012222221
000000000000
000000000000