058104293-red-planet-saturn-moon.jpg
0, 0, 128, 255
128, 0, 128, 255
183, 0, 183, 255
0, 151, 0, 255
210, 0, 105, 255
Colormap
000000000000
000000000000
000000000000
333333333333
000033330000
000000000000
222222222222
000022220000
000000000000
111111111111
000011110000
000000000000
000000000000
Brickmap
000000000000
000000000000
000000000000
333333333333
000033330000
000000000000
222222222222
000022220000
000000000000
111111111111
000011110000
000000000000
000000000000