068717925-lava-landscape-3d-illustration.jpg
192, 192, 192, 255
128, 0, 128, 255
255, 4, 130, 255
0, 113, 255, 255
179, 102, 102, 255
Colormap
000000000000
221100001122
222221122222
333321123333
000321123000
000322223000
333333333333
111111111111
010101010101
222220022222
000333333000
000000000000
000000000000
Brickmap
000000000000
221100001122
222221122222
333321123333
000321123000
000322223000
333333333333
111111111111
010101010101
222220022222
000333333000
000000000000
000000000000