068717925-lava-landscape-3d-illustration.jpg
192, 192, 192, 255
128, 0, 128, 255
255, 4, 130, 255
0, 113, 255, 255
179, 102, 102, 255
Colormap
000000000000
033300003330
333311113333
111111111111
111111111111
222221122222
333321123333
001100001100
003211112300
111111111111
003300003300
000000000000
000000000000
Brickmap
000000000000
033300003330
333311113333
111111111111
111111111111
222221122222
333321123333
001100001100
003211112300
111111111111
003300003300
000000000000
000000000000