068717925-lava-landscape-3d-illustration.jpg
192, 192, 192, 255
128, 0, 128, 255
255, 4, 130, 255
0, 113, 255, 255
179, 102, 102, 255
Colormap
022211112220
021111111120
021111111120
021111111120
033333333330
110000000011
333333333333
001111111100
000333333000
002222222200
033300003330
000000000000
000000000000
Brickmap
022211112220
021111111120
021111111120
021111111120
033333333330
110000000011
333333333333
001111111100
000333333000
002222222200
033300003330
000000000000
000000000000