068717925-lava-landscape-3d-illustration.jpg
192, 192, 192, 255
128, 0, 128, 255
255, 4, 130, 255
0, 113, 255, 255
179, 102, 102, 255
Colormap
000000000000
222000000222
000022220000
002222222200
222222222222
001100001100
003211112300
000321123000
000321123000
111001100111
222002200222
000000000000
000000000000
Brickmap
000000000000
222000000222
000022220000
002222222200
222222222222
001100001100
003211112300
000321123000
000321123000
111001100111
222002200222
000000000000
000000000000