068717925-lava-landscape-3d-illustration.jpg
192, 192, 192, 255
128, 0, 128, 255
255, 4, 130, 255
0, 113, 255, 255
179, 102, 102, 255
Colormap
000000000000
000000000000
000000000000
111100001111
000022220000
333300003333
000000000000
333300003333
000022220000
111100001111
000000000000
000000000000
000000000000
Brickmap
000000000000
000000000000
000000000000
111100001111
000022220000
333300003333
000000000000
333300003333
000022220000
111100001111
000000000000
000000000000
000000000000