068717925-lava-landscape-3d-illustration.jpg
192, 192, 192, 255
128, 0, 128, 255
255, 4, 130, 255
0, 113, 255, 255
179, 102, 102, 255
Colormap
000321123000
222000000222
033333333330
000022220000
220000000022
021112211120
022222222220
222000000222
000333333000
000321123000
000000000000
000000000000
000000000000
Brickmap
000321123000
222000000222
033333333330
000022220000
220000000022
021112211120
022222222220
222000000222
000333333000
000321123000
000000000000
000000000000
000000000000