068717925-lava-landscape-3d-illustration.jpg
192, 192, 192, 255
128, 0, 128, 255
255, 4, 130, 255
0, 113, 255, 255
179, 102, 102, 255
Colormap
000000000000
222221122222
021112211120
022222222220
000011110000
000000011220
011220000000
000002331200
000011212121
000111000000
000000000000
000000000000
000000000000
Brickmap
000000000000
222221122222
021112211120
022222222220
000011110000
000000011220
011220000000
000002331200
000011212121
000111000000
000000000000
000000000000
000000000000