068717925-lava-landscape-3d-illustration.jpg
192, 192, 192, 255
128, 0, 128, 255
255, 4, 130, 255
0, 113, 255, 255
179, 102, 102, 255
Colormap
022211112220
333333333333
000011110000
022222222220
000022220000
003303303300
000330033000
000033330000
000001100000
111133000000
000033333333
000000000000
000000000000
Brickmap
022211112220
333333333333
000011110000
022222222220
000022220000
003303303300
000330033000
000033330000
000001100000
111133000000
000033333333
000000000000
000000000000