068717925-lava-landscape-3d-illustration.jpg
192, 192, 192, 255
128, 0, 128, 255
255, 4, 130, 255
0, 113, 255, 255
179, 102, 102, 255
Colormap
200000000002
222220022222
222002200222
000000222222
000011212121
011000000000
000022220000
220000000022
330033330033
330033330033
000000000000
000000000000
000000000000
Brickmap
200000000002
222220022222
222002200222
000000222222
000011212121
011000000000
000022220000
220000000022
330033330033
330033330033
000000000000
000000000000
000000000000