068717925-lava-landscape-3d-illustration.jpg
192, 192, 192, 255
128, 0, 128, 255
255, 4, 130, 255
0, 113, 255, 255
179, 102, 102, 255
Colormap
033300003330
022200002220
222221122222
021112211120
022222222220
222220022222
222200002222
222000000222
111001100111
222002200222
000000000000
000000000000
000000000000
Brickmap
033300003330
022200002220
222221122222
021112211120
022222222220
222220022222
222200002222
222000000222
111001100111
222002200222
000000000000
000000000000
000000000000