068717925-lava-landscape-3d-illustration.jpg
192, 192, 192, 255
128, 0, 128, 255
255, 4, 130, 255
0, 113, 255, 255
179, 102, 102, 255
Colormap
000000000000
033300003330
022200002220
222220022222
111100001111
330000000033
000333001111
333001111111
000333001111
111111111111
001100001100
000000000000
000000000000
Brickmap
000000000000
033300003330
022200002220
222220022222
111100001111
330000000033
000333001111
333001111111
000333001111
111111111111
001100001100
000000000000
000000000000